{
	"0":{"x":0, "y":0},
	"1":{"x":1, "y":0},
	"2":{"x":2, "y":0},
	"3":{"x":0, "y":1},
	"4":{"x":1, "y":1},
	"5":{"x":2, "y":1},
	"6":{"x":0, "y":2},
	"7":{"x":1, "y":2},
	"8":{"x":3, "y":2}
}